1111111111111111111111111
1000000000000000000000001
1000000000000000000000001
1000000000000000010000001
1111111000000000010000001
1000001111111111110000001
1000000010000000000000001
1000000010000000000000001
1000011110000000000000001
1000010000000000000000001
1000010000000111111100001
1000010000000000000000001
1000010000000000000000001
1000010000000000011100001
1000011111111111110000001
1000000000000000000000001
1000000000000000000000001
1000000000000000000000001
1000000000000000000000001
1111111111111111111111111
